+--+--+--+--+--+--+--+--+--+--+--+--+--+--+--+--+--+--+--+--+
G     |           |                       |        |  |     |
+  +  +  +--+--+  +  +--+  +--+--+--+  +  +  +--+  +  +  +  +
|  |  |        |  |     |  |        |  |     |     |     |  |
+  +  +--+  +  +  +--+  +  +--+--+  +  +--+--+  +--+--+  +  +
|  |  |     |  |     |  |           |     |     |     |  |  |
+  +  +  +--+--+--+  +  +--+--+--+  +--+  +  +--+--+  +  +  +
|  |  |  |           |        |     |     |           |  |  |
+  +  +  +  +--+  +--+--+--+  +  +--+--+--+  +--+--+--+--+  +
|  |     |     |  |        |  |  |     |     |              |
+  +--+--+--+  +  +  +--+  +  +  +  +  +  +--+--+  +--+--+--+
|  |  |     |  |     |     |  |  |  |  |     |     |  |     |
+  +  +  +  +--+--+--+--+--+  +  +--+  +--+  +  +--+  +  +--+
|     |  |              |     |     |  |     |  |  |  |     |
+--+  +  +--+--+--+--+  +  +--+--+  +  +  +--+  +  +  +--+  +
|     |  |        |        |           |     |           |  |
+  +--+  +--+--+  +  +--+--+  +--+--+--+--+  +--+--+  +--+  +
|     |     |  |  |        |  |        |     |     |  |     |
+--+  +--+  +  +  +--+--+--+  +  +--+  +  +--+--+  +  +  +--+
|     |     |  |     |     |  |  |     |        |     |     |
+  +--+  +--+  +--+  +  +  +  +  +  +--+--+--+  +  +--+  +  +
|        |  |     |     |        |  |        |  |     |  |  |
+--+--+  +  +--+  +--+--+--+  +--+  +  +--+  +  +--+  +  +--+
|     |  |  |  |        |     |     |     |  |     |  |     |
+  +  +--+  +  +--+--+  +  +--+  +--+--+  +  +--+  +  +--+  +
|  |  |     |        |  |  |     |        |        |        |
+  +  +  +--+  +--+  +  +--+  +--+--+--+--+--+--+--+  +--+--+
|  |  |  |     |  |  |     |           |     |     |  |     |
+  +  +  +--+  +  +  +--+  +--+--+--+  +--+  +  +  +  +  +--+
|  |  |           |     |              |     |  |  |        |
+  +  +--+--+  +--+--+  +--+--+  +  +--+  +--+  +  +--+  +  +
|  |     |     |     |     |     |  |  |     |  |     |  |  |
+  +--+  +  +--+  +--+--+  +  +--+  +  +--+  +--+--+  +--+  +
|  |     |     |              |     |           |        |  |
+  +  +--+--+  +--+--+--+--+--+  +--+  +--+  +  +  +  +  +  +
|  |     |     |              |  |     |     |     |  |     |
+  +--+--+  +--+--+--+  +--+  +  +--+--+  +--+--+--+  +--+--+
|  |        |              |     |        |           |     |
+  +  +--+--+  +--+--+  +--+--+--+  +--+--+  +  +--+--+  +  +
|     |        |                    |        |           |  S
+--+--+--+--+--+--+--+--+--+--+--+--+--+--+--+--+--+--+--+--+